[
	[ 4, 0, 0, 0, 0, 0, 0, 0, 0, 0, 0, 0, 0, 0, 0, 0, 0, 0, 0, 0, 0, 0, 0, 0, 0, 0, 0, 0, 0, 0, 0, 0, 0, 0, 0, 0, 0, 0, 0, 0, 0, 0, 0, 0, 0,10, 0, 0, 0, 0, 0, 0, 0, 0, 0, 0, 0, 0, 0, 0, 0, 0, 0, 0, 0, 0, 0, 0, 0, 0, 0, 0, 0, 0, 0, 0, 0, 0, 0, 0, 0, 0, 0, 0, 0, 0, 0, 0],
	[ 2, 0, 0, 0, 0, 0, 0, 0, 0, 0, 0, 0, 0, 0, 0, 0, 0, 9, 1, 4, 0, 0, 0, 0, 0, 0, 0, 0, 0, 0, 0, 0, 0, 0, 0, 0, 0, 0, 0, 0,10, 0, 0, 0, 0, 0, 0, 0, 0, 0, 0, 0, 0, 0, 0, 0, 0, 0, 0, 0, 0, 0, 0, 0, 0, 0, 0, 0, 0, 0, 0, 0, 0, 0, 0, 0, 0, 0, 0, 0, 0, 0, 0, 0, 0, 0, 0, 0],
	[ 2, 0, 0, 0, 0, 0, 0, 0, 0, 0, 0, 0, 0, 0, 0, 0, 9, 7,17,11, 0, 0, 0, 0, 0, 0, 0, 0, 0, 0, 0, 0, 9, 0, 0,10, 1, 9, 0, 0, 0, 0, 0, 0, 0, 0, 0, 0, 0, 0, 0, 0, 0, 0, 0, 0, 0, 0, 0, 0, 0, 0, 0, 0, 0, 0, 0, 0, 0, 0, 0, 0, 0, 0, 0, 0, 0, 0, 0, 0, 0, 0, 0, 0, 0, 0, 0, 0],
	[ 2, 0, 0, 0, 0, 0, 0, 0, 0,13,14, 4, 0, 0, 0, 9, 7,17,18, 0, 0, 0, 0, 0, 5, 4, 0, 0, 0, 0, 1, 1, 1, 1, 1, 1, 1, 1, 1, 1, 1, 1, 1, 1, 1, 1, 1, 1, 1, 1, 1, 1, 1, 1, 1, 1, 1, 1, 1, 1, 1, 1, 1, 0, 0, 0, 0, 0, 0, 0, 0, 0, 0, 0, 0, 0, 0, 0, 0, 0, 0, 0, 0, 0, 0, 0, 0, 0],
	[ 2, 0, 0, 0, 0, 0, 0, 0, 0,12, 8, 6, 1, 1, 1, 7, 8,18, 0, 0, 0, 0, 0, 0, 3, 6, 4, 0, 0, 0, 0, 0, 0, 0, 0, 0, 0, 0, 0, 0, 0, 0, 0, 0, 0, 0, 0, 0, 0, 0, 0, 0, 0, 0, 0, 0, 0, 0, 0, 0, 0, 0, 0, 0, 0, 0, 0, 0, 0, 0, 0, 0, 0, 0, 0, 0, 0, 0, 0, 0, 0, 0, 0, 0, 0, 0, 0, 0],
	[ 2, 0, 0, 0, 0, 0, 0, 0, 0, 0, 0, 8, 8, 8, 8,18, 0, 0, 0, 0, 0, 0, 0, 0, 3,17, 6,10, 0, 0, 0, 0, 0, 0, 0, 0, 0, 0, 0, 0, 0, 0, 0, 0, 0, 0, 0, 0, 0, 0, 0, 0, 0, 0, 0, 0, 0, 0, 0, 0, 0, 0, 0, 0, 0, 0, 0, 0, 0, 0, 0, 0, 0, 0, 0, 0, 0, 0, 0, 0, 0, 0, 0, 0, 0, 0, 0, 0],
	[ 2, 0, 0, 0, 0, 5,15,16, 0, 0, 0, 0, 0, 0, 0, 0, 0, 0, 0, 0, 0, 0, 0, 0, 3,17,17, 2, 0, 0, 0, 0, 0, 0, 0, 0, 0, 0, 0, 0, 0, 0, 0, 0, 0, 0, 0, 0, 0, 0, 0, 0, 0, 0, 0, 0, 0, 0, 0, 0, 0, 0, 0, 0, 0, 0, 0, 0, 0, 0, 0, 0, 0, 0, 0, 0, 0, 0, 0, 0, 0, 0, 0, 0, 0, 0, 0, 0],
	[ 2, 0, 0, 0, 0,12, 8, 6,10, 0, 0, 0, 0, 0, 0, 0, 0, 0, 0, 0, 0, 0, 0, 0, 3,17,17, 2, 0, 0, 0, 0, 0, 0, 0, 0, 0, 0, 0, 0, 0, 0, 0, 0, 0, 0, 0, 0, 0, 0, 0, 0, 0, 0, 0, 0, 0, 0, 0, 0, 0, 0, 0, 0, 0, 0, 0, 0, 0, 0, 0, 0, 0, 0, 0, 0, 0, 0, 0, 0, 0, 0, 0, 0, 0, 0, 0, 0],
	[ 2, 0, 0, 0, 0, 0, 0, 8, 6, 1, 1, 4, 0, 0, 0, 0, 0, 0, 0, 0, 0, 0, 0, 0, 3,17,17, 6,10, 0, 0, 0, 0, 0, 0, 0, 0, 0, 0, 0, 0, 0, 0, 0, 0, 0, 0, 0, 0, 0, 0, 0, 0, 0, 0, 0, 0, 0, 0, 0, 0, 0, 0, 0, 0, 0, 0, 0, 0, 0, 0, 0, 0, 0, 0, 0, 0, 0, 0, 0, 0, 0, 0, 0, 0, 0, 0, 0],
	[ 2, 0, 0, 0, 0, 0, 0, 0, 8, 8, 8,11, 0, 0, 0, 0, 0, 0, 0, 0, 0, 0, 0, 0, 3,17,17,17, 6,15,16, 0, 0, 0, 0, 0, 0, 0, 0, 0, 0, 0, 0, 0, 0, 0, 0, 0, 0, 0, 0, 0, 0, 0, 0, 0, 0, 0, 0, 0, 0, 0, 0, 0, 0, 0, 0, 0, 0, 0, 0, 0, 0, 0, 0, 0, 0, 0, 0, 0, 0, 0, 0, 0, 0, 0, 0, 0],
	[ 2, 0, 0, 0, 0, 0, 0, 0, 0, 0, 0, 0, 0, 0, 0, 0, 0, 0, 0, 0, 0, 0, 0, 0, 3,17,17,17,17,17, 6,15,16, 0, 0, 0, 0, 0, 0, 0, 0, 0, 0, 0, 0, 0, 0, 0, 0, 0, 0, 0, 0, 0, 0, 0, 0, 0, 0, 0,13,14, 1,15,16, 0,13,14, 1,10, 0, 0, 0, 0, 0, 0, 0, 0, 0, 0, 0, 0, 0, 0, 0, 0, 0, 0],
	[ 2, 0, 0, 0, 0, 0, 0, 0, 0, 0, 0, 0, 0, 0, 9, 1, 1, 4, 0, 0, 0, 0, 0, 9, 7,17,17,17,17,17,17,17, 6,10, 9,10, 9,10, 0, 0, 9,10, 0, 0, 0, 0, 0, 0, 0, 0, 0, 9,10, 0, 0, 0, 0, 0,13,14, 7,17,17,17,17, 1,17,17,17,17,10, 0, 0, 0, 0, 0, 0, 0, 0, 0, 0, 0, 0, 0, 0, 0, 0, 0],
	[ 2, 0, 0, 0, 0, 0, 0, 0, 0, 0, 0, 0,13,14, 7,17,17, 6, 4, 0, 0, 0, 5, 7,17,17,17,17,17,17,17,17,17, 6, 7, 6, 7, 6,15,16, 0, 0,15,16, 0,10, 0, 9, 9,13,14, 0, 0,13,14, 0, 0, 9, 7,17,17,17,17,17,17,17,17,17,17,17,17,15,16, 0,13,14, 0, 0, 0, 0, 0, 0, 0, 0, 0, 0, 0, 0],
	[ 2, 0, 0, 0, 0, 0, 0, 0, 0, 0, 0, 9, 7,17,17,17,17,17, 2, 0, 0, 5, 7,17,17,17,17,17,17,17,17,17,17,17,17,17,17,17,17, 6, 4, 0, 0, 6, 1, 0, 0, 0, 1, 7,18, 0, 5, 7, 2, 0, 0, 3,17,17,18, 0, 0, 0, 0,17,17,17,17,17,17,17,17, 1,17,18, 0, 0, 0, 0, 0, 0, 0, 0, 0, 0, 0, 0],
	[ 2, 0, 0, 0, 0, 0, 5, 1, 1, 1, 1, 7,17,17,17,17,17,17, 2, 0, 5, 7,17,17,17,17,17,17,17,17,17,17,17,17,17,17,17,17,17,17, 2, 0, 0, 0, 0, 0, 0, 0, 0, 0, 0, 0, 3,17, 2, 0, 9, 7, 8,18, 0, 0, 0, 0, 0, 0,17,17,17,17,17,17,17, 8,18, 0, 0, 0, 0, 0, 9, 0, 0, 0, 0, 0, 0, 0],
	[ 2, 0,10, 0, 0, 0, 3,17,17,17,17,17,17,17,17,17,17,17, 6, 1, 7,17,17,17,17,17,17,17,17,17,17,17,17,17,17,17,17,17,17,17, 2, 0, 0, 0, 0, 0, 0, 0, 0, 0, 0, 0, 3,17, 2, 0, 0, 0, 0, 0, 0, 0, 0, 0, 0, 0, 0, 0, 0, 8, 8, 8,18, 0, 0, 0, 0, 0, 5, 1, 7, 0, 0, 0, 0, 0, 0, 0],
	[ 2, 0, 0, 0, 5, 1, 7,17,17,17,17,17,17,17,17,17,17,17,17,17,17,17,17,17,17,17,17,17,17,17,17,17,17,17,17,17,17,17,17,17, 6,10, 0, 0, 0, 0, 0, 0, 0, 0, 9, 1, 7,17, 2, 0, 0, 0, 0, 0, 0, 0, 0, 0, 0, 0, 0, 0, 0, 0, 0, 0, 0, 0, 0, 0, 0, 5, 7,17,17, 0, 0, 0, 0, 0, 0, 0],
	[ 6, 1, 4, 0, 3,17,17,17,17,17,17,17,17,17,17,17,17,17,17,17,17,17,17,17,17,17,17,17,17,17,17,17,17,17,17,17,17,17,17,17,17, 6, 1,15,16, 0, 0, 0,13,14, 7,17,17,17, 6,10, 0, 0, 0, 0, 0, 9, 1, 1, 1,10, 0, 0, 0, 0, 0, 0, 0, 0, 9, 1, 1, 7,17,17,17, 0, 0, 0, 0, 0, 0, 0],
	[17,17, 6, 1, 7,17,17,17,17,17,17,17,17,17,17,17,17,17,17,17,17,17,17,17,17,17,17,17,17,17,17,17,17,17,17,17,17,17,17,17,17,17,17,17, 6, 1, 1, 1, 7,17,17,17,17,17,17, 6, 1, 1, 1, 1, 1, 7,17,17,17, 6, 1, 1, 1, 1, 1, 1, 1, 1, 7,17,17,17,17,17,17, 0, 0, 0, 0, 0, 0, 0]
]
